8
12
Ground
25333362
12222222
22222212
22222222
22222222
22122222
22222222
22222222
22222221
22222222
22222222
15333362
Entities
..e..e..
........
.##.....
........
........
........
........
........
........
.....##.
........
.ep..p..